1111111111111111111111111111111111
1E1000000000000C000000000000000001
1000010100100000101001000000010101
101P000010101010001001000000010101
1000000000000000000000000000000001
1111111111111111111111111111111111