1111111111111
10010000000C1
10L0011111001
1LP0110E00001
1111111111111