11111111111111111111111111
1P000C010CCE0000000C11C001
10001C000000100000C0CCC001
11111111111111111111111111