111111111111111111111111111
1P0000000100000C00001000001
101111110111111111101111101
101000010000000000100000101
101010111111111110111110101
101010000000010000000010101
101011111110101111111010101
100010000010100000000010101
111110111110111111111110101
100000100000100000000000101
101110101111101111111111101
101010100000000000000000101
101010111111111111111110101
100010000000000000000010101
111011111111111111111010101
100010000000000000001000E01
111111111111111111111111111