111111111111111111111111111111111111111111111111111111111111
1P0000000000000000000000000000000000000000000000000000000001
100000000000000000000000000000000000000000000000000000000001
100000000111100000111111100001111111000011111111100000000001
100000001101100000111111100001111111000011000001100000000001
100000011001100000000001100000000011000000000001100000000001
100000110001100000111111100001111111000000000001100000000001
100000000001100000111111100001111111000000000001100000000001
100000000001100000000001100000000011000000000001100000000001
100000000011110000111111100001111111000000000001100000000001
100000000111111000111111100001111111000000000001100000000001
100000000000000000000000000000000000000E00000000000000000001
100000000000000000000000000000000000000000000000000000000001
10000000000000000000000CCCCC0000CCCCC00000000000000000000001
1000000000000000000000CCC0CC000CC00CCC0000000000000000000001
100000000000000000000CCC00CC000C0000CC0000000000000000000001
10000000000000000000CCC000CC0000000CC00000000000000000000001
1000000000000000000CCC0000CC000000CC0000C0000000000000000001
100000000000000000CCC00000CC00000CCCCCCC00000000000000000001
10000000000000000CCCCCCCCCCCCC00CCCCCCC000000000000000000001
10000000000000000CCCCCCCCCCCCC000000000000000000000000000001
10000000000000000000000000CC00000000000000000000000000000001
10000000000000000000000000CC00000000000000000000000000000001
100000000000000000000000000000000000000000000000000000000001
100000000000000000000000000000000000000000000000000000000001
100000000000000000000000000000000000000000000000000000000001
111111111111111111111111111111111111111111111111111111111111