1111111111111111111111111111111
10000P00000E0110000000000000001
1011110111000110111111011111101
1010000100000000000000010000101
1010111101111000111111011101101
100010000000000000C000000000001
1111111111111111111111111111111