1111111111111111111111111111111111111111
10000000C00000L000C0000L00C0000000000001
10111011111111111110111111111111111110L1
1000001000C000L000000000C00L0000C0000001
10111011101111111110111111111111111110C1
1P000010C0100L0000000C0000L000C000000001
10111011101011111110111111111111111110L1
100L001000101000000000000C00L000C0000001
10111011100101011111011111111111111110C1
10C00010001010L000000C0000L000C000000001
10111011101010111110111111111111111110L1
1000C010C01010000000000000L000C000000001
10111011101110111110111111111111111110C1
100L001000000000L0000C0000L000C000000001
10111011111111111110111111111111111110L1
10C0000000C00000000000000000000C00E00001
1111111111111111111111111111111111111111