1111111111111111111111111111111111111111111111
10P00000000000001111111111100000000000000E0001
1011111111101111111111111111110111111111111101
1000000000100000000000000000000000000000000001
1011101111111110111111111111111111011111111101
1000100000000010000000000000000001000000000101
1111111111101111111111111110111111111110111101
1000000000000000000000000000100000000000000001
1011111111111110111111111111111111111111111101
1000000000000010000000000000000000000000000001
1011111111111111110111111111111111111111111101
1000000000100000000000000000000000000000000001
1011101111111111111111111110111111110111111101
1000100000000000000000000000100000000000000101
1111111111111111111111111111111111111111111111