1111111111111111111111111111111
1010001100000000000000000000001
100P001100000000000000000000001
1111111100000000000000000000001
1010000000000000000000000000001
1111111111111111111111111111111