1111111111111111111111111111111
1010001100000000000000000001111
100P0000000000000000000E0001C01
1111111100000000000000000001111
1010000000000000000000000000001
1111111111111111111111111111111