1111111111111111111111111111111
1010001100000000000000000000001
100P0011000000000000000C0000E01
1111111100000000000000000000001
1010000000000000000000000000001
1111111111111111111111111111111