1111111111111111111111111111111
101000110000000000000000000E001
100P00110000000C000000000000001
1111100000000000000000000000001
1010000000000000000000000000001
1111111111111110111111111111111