1111111111111111111111111111111
1010001100000000000000000000001
100P000E00000000000000000000001
111111110000000000000C000000001
1010000000000000000000000000001
11111111111111111111111111111111